* * * * * * * * * * * * * * * * * * * * *
* @ . * * . . . . * * * * . . . . * . . *
* * . * . . * * . * * * * . * * * * . * *
* * . . . * * * . . . * * . . . . . . . *
* * * * * . . . * * . . . . * * * . * * *
* . . * * . * . . . . * * * * * * . . . *
* * . . . . * * . * * . . . * * * * * . *
* * * * * * . . . * * . * . . * . . . * *
* x . . . . . * . . . . * * . . . * . . *
* * * * * * * * * * * * * * * * * * * * *