* * * * * * * * * * * * * * * * * * * * *
* @ * * . . . . . . * * * * * * * * * * *
* . * * . * * * * . * * . . . * . . . . *
* . . . . * * . . . * * . * . * * . * . *
* * * * * . . . * . . . . * . . . . * . *
* x . * * * * * * * * * * * * * * * * . *
* * . . * . . . . . * . . . * * . . * . *
* * * . . . * * * . * . * . * . . * * . *
* . * . * . * * . . . . * . * * . * * . *
* . . . * . . * . * * * * . . . . . . . *
* * * * * * * * * * * * * * * * * * * * *