* * * * * * * * * * * * * * * * * * *
* @ . . * * * * . . . * * * * . . x *
* * * . * * * * . * . * * . . . * * *
* * . . * * * * . * . * * . * * * * *
* * . * * * * * . * . * * . . . . . *
* * . * * * * * . * . . . . * * * * *
* * . . . . . . . * * * * * * * * * *
* * * * * * * * * * * * * * * * * * *