* * * * * * * * * * * * * * * * * * * * * *
* @ . . . . . . * * . . . * . . * . . . . *
* * * . * . * . . . . * . . . * * . * * * *
* . . . * . * * * . * * * * * * * . * . * *
* . * * * * * * * . . * . . . . . . . . * *
* . * * . . . * * * * * . * * . * * * * * *
* . * * . * . . . . * * . * * . . . . . * *
* . . . . * * * * . . . . * . . * * * . x *
* * * * * * * * * * * * * * * * * * * * * *