* * * * * * * * * * * * * * * * *
* @ . . . . * * . . . . . . . x *
* * * * * . * * . * * * . * * * *
* * * * * . * * * * * * . * * * *
* * * * * . * * * * * * . . . * *
* * * * * . * * * * * * * * . * *
* * * * * . . . . . . . . . . * *
* * * * * * * * * * * * * * * * *