* * * * * * * * * * * * * * * * * * * *
* @ * * * * * * * * * * . . . . . . . *
* . . . . * * * * . . . . * * * * * * *
* . * * . . * . . . * * . . . . . . . *
* . * . . * * . * . * * * * . * * * * *
* . * * * * * . * * * * * * . * . . x *
* . . . . . . . * * * * * * . . . * * *
* * * * * * * * * * * * * * * * * * * *